1111111
1P00001
1000001
10C0E00
1111111