1111111
10A0001
1000B01
10000C1
1111111