111111111111
1P00000000E1
100000000001
100000000001
111111111111