1111111
1P00001
1000001
10C0E01
1000001
10P0001
1111111