111111111111
1P0000000001
100000000001
10C000000001
111111111111