111111111111111111111111111111111111111111111111111111111111111111111111
100001000000000000000000000000000000000000000000000000000000000000000001
111100010110000000000000000000000000000000000000000000000000000000000001
1001111101C0000000000000000000000000000000000000000000000000000000000001
100C00000000000000000000000000000000000000000000000000000000000000000001
101111P01110000000000000000000000000000000000000000000000000000000000001
100010001E00000000000000000000000000000000000000000000000000000000000001
111111001100000000000000000000000000000000000000000000000000000000000001
1C0000000000000000000000000000000000000000000000000000000000000000000001
1C0000000000000000000000000000000000000000000000000000000000000000000001
1C0000000000000000000000000000000000000000000000000000000000000000000001
1C0000000000000000000000000000000000000000000000000000000000000000000001
1C0000000000000000000000000000000000000000000000000000000000000000000001
1C0000000000000000000000000000000000000000000000000000000000000000000001
1C0000000000000000000000000000000000000000000000000000000000000000000001
1C0000000000000000000000000000000000000000000000000000000000000000000001
1C0000000000000000000000000000000000000000000000000000000000000000000001
111111111111111111111111111111111111111111111111111111111111111111111111