111111111111
100001000001
111100010111
1001111101C1
100C00000001
101110P01111
100010001E01
111111001101
1C0000000001
111111111111