111111111111111111111
10001C001C000000100C1
101011101110111010111
1E1000101P101C0000001
111010101010111011101
1C00100010001000C1001
111110111011101111011
1C1000000010001000001
101011101011101011101
10001C0010001C0001C01
111111111111111111111